11 11
  *********
*         *
******** **
*  * *** **
* **   *  *
* ****** **
*  *     **
* ** *** */
******** **
        /**
***********
